20 20
1 1
59 51 51 51 51 51 51 51 51 51 51 51 51 51 51 51 51 51 51 58
54 11 11 10 10 10 10 10 10 10 10 10 10 10 57 10 10 10 10 55
54 11 11 10 10 10 10 10 10 10 10 10 10 10 57 10 10 10 10 55
54 10 10 10 10 10 10 10 10 10 10 10 10 10 57 10 10 10 10 55
54 10 10 10 10 10 10 10 10 10 10 10 10 10 57 10 10 10 10 55
54 10 10 10 10 10 10 10 10 10 10 10 10 10 57 10 10 10 10 55
54 10 10 10 10 10 10 10 10 10 10 10 10 10 10 10 10 10 10 55
54 10 10 10 10 10 10 10 10 10 10 10 10 10 10 10 10 10 10 55
54 10 10 10 10 10 10 10 10 10 10 10 10 10 57 10 10 10 10 55
54 10 10 10 10 10 10 10 10 10 10 10 10 10 57 10 10 10 10 55
54 10 10 10 10 10 10 10 10 10 10 10 10 10 57 10 10 10 10 55
54 10 10 10 10 10 10 10 10 10 10 10 10 10 57 10 10 10 10 55
54 10 10 10 10 10 10 10 10 10 10 10 10 10 57 10 10 10 10 55
54 10 10 10 10 10 10 10 10 10 10 10 10 10 57 10 10 10 10 55
54 10 10 10 10 10 10 10 10 10 10 10 10 10 57 10 10 10 10 55
54 10 10 10 10 10 10 10 10 10 10 10 10 10 57 10 10 10 10 55
54 10 10 10 10 10 10 10 10 10 10 10 10 10 57 10 10 10 10 55
54 10 10 10 10 10 10 10 10 10 10 10 10 10 57 10 10 10 10 55
54 10 10 10 10 10 10 10 10 10 10 10 10 10 57 10 10 10 10 55
63 50 50 50 50 50 50 50 50 50 50 50 50 50 50 50 50 50 50 62